1111111111111111111111111111111111
10100101001000001010010000000101E1
10100100101010100010010000000101P1
100000000C00C0000000000000000000C1
1111111111111111111111111111111111