1111111111111
10010000001C1
10000111C0101
1P0011C00CE01
1111111111111