111111111111111
1P0000000000C01
110000000000001
111011111111101
111011111111101
111000000000001
111010111010101
111010111010101
111000000000001
111011111111101
111011111111101
111000000000001
1110E0000000011
111111111111111