111111111111111111111111111111111111111111111111111111111111
1C1000000000000000001000100000100000100000001010001000000011
101111101111111110111011101010101110111110101010101011111011
10000010000000001000100000101010101010000010001010001C000011
111110111110111011101111111011101010101011101110111111101011
100010100010100010001000100000000010001010001000100000001011
111010101010101110111010111111101111101011111011101111101111
100010001010101010000010001000101000101010000000100000100011
101111111010101011111111101010111010111010111111101110111011
100010000010101000100000101010000010001000001000100010100011
101010111111101110101110101011111111101111111010111110101111
101000100000001000001000100010000010101000000010001000101C11
101111101111111111111110111110101010101011111111101011101011
101000000000100000001C001000P0101000101010001000001010000011
101110111010101110101011101111101111101010101011111011111111
100010001010001000101000001000100010101010100010001000100011
111010101111111011101111101010101010101011111010101010101011
100010101000001000101000101010101000000010000010101010101011
101110101010101110111010101010111111111110111110111010101011
101000101010100010000010101010000010100000001000001010001011
101011101110111011101110111011111010101111111011101011111011
101000100000100010000010001010000010001010000000101010000011
101111111111111111111011101010111110111010111111101010111011
100000100000001000001000100010001010000010000010001010100011
111110101111101011101111111111101011111011111110101110101111
100010101000101010101000000000001000001000001000100010100011
101010101010101010101011111111111011101111101011111010111111
101010001010100010000000100000101000100000100010000010000011
101011111011111111111010111010101110111111111110111111101011
1C10000000C0000000000010000010000010000000000000000000001011
1111111111111111111111111111111111111111111111111111111110E1
111111111111111111111111111111111111111111111111111111111111
