111111111111111111111111111111111111
1P0000000000000000000000000000000011
101111111111111011111111111111101111
100000000000001000000000000000100001
101111111110111011111111101111101001
100000000010000000000001000000100C01
111111111010111111111101011111111101
100000001000100000001000000000000001
101111101111111111101111111111111101
100000100000000C00100000000000000001
111111101111111111101111111111111101
1C0000000000000000000000000000000001
101111111111111111101111111111110111
100000C00000000000000000000000000CE1
111111111111111111111111111111111111
